################################
########################.......#
########################.......#
#..............................#
#..............................#
####....################.......#
#..#....#.................##..##
#..#....#.................#....#
#..#......................#....#
#..#......................#....#
#..######.................#....#
#.........................#....#
#.......................###....#
#......................##......#
#..............................#
#..............................#
#...................#####......#
#..............#####....########
#..............#...............#
#..............#...............#
#..............#...............#
#...##...##....................#
#...##...##....................#
#...##...##....................#
#...##...###############.......#
#........#################.....#
#..............................#
#..............................#
#..............................#
#....####..####..####..####....#
#...#....##....##....##....#...#
################################
