################
#..#..#...#....#
#..#..#...#....#
#..#..#...#....#
#..#..#####....#
#..............#
#..............#
#..............#
#..............#
#..............#
#..........###.#
#......#.......#
#......#.......#
#......#.......#
#..............#
################
