################################
#..............................#
########################.......#
#..............................#
#..............................#
####....################.......#
#..#....#.................##..##
#..#....#.................#....#
#..#......................#....#
#..#......................#....#
#..######.................#....#
#.........................#....#
#.......................###....#
#......................##......#
#..............................#
#..............................#
#......................##......#
#.......................########
#..............................#
#..............................#
#..............................#
#...##...##....................#
#...##...##....................#
#...##...##....................#
#...##...###############.......#
#........#################...###
#..............................#
#..............................#
#..............................#
#..............................#
#..............................#
################################
